R 1920 1080
EA  ./path_to_the_east_texture
WE ./path_to_the_west_texture
NO ./path_to_the_north_texture
SO ./path_to_the_south_texture

S ./path_to_the_sprite_texture
F 220,100,0
C 225,30,0

        1111111111111111111111111
        1000000000110000000000001
        1011000001110000002000001
        1001000000000000000000001
111111111011000001110000001000001
100000000011000001110111110111111
11110111111111011100000010001
11110111111111011101010010001111111
110000001101010111000000100N0000001
10002000000000001100000010001111111
100000000000000011010100001011111
1100000111010101111101110000011111
11110111 1110101 1011110001111111
11111111 1111111 11111111111111111