R 1000 800
EA ./textures/anime_4.xpm
WE ./textures/anime_2.xpm
NO ./textures/anime_3.xpm
SO ./textures/anime_5.xpm

S ./textures/anime_s3.xpm
F 148,210,246
C 240,158,218

        1111111111111111111111111
        1000200020020020020020021
        100N002000020002200002201
        1000200000020020002020001
        1000000020200200020200001
        1000000000000020000202001
        1000002000020000200000001
        1000000000020000000022001
111111111011000000000000200000001
100000000011000001110111110111111
11110111111111011100000010001
11110111111111011101010010001111111
11000000110101011100000010000000001
10002000000000001100000010001111111
100000000000000011010100001011111
1100000111010101110101110000011111
11110111 1110101 1011110000011111
11111111 1111111 11111111111111111