R 1000 800
EA ./textures/brick.xpm
WE ./textures/metal.xpm
NO ./textures/wood.xpm
SO ./textures/stone.xpm

S ./textures/catto.xpm
F 148,210,246
C 240,158,218

        1111111111111111111111111
        1000000000110000000000001
        101100000111000000000N001
        1001000000000000002000001
111111111011000001110000000000001
100000000011000001110111110111111
11110111111111011100000010001
11110111111111011101010010001111111
11000000110101011100000010000000001
10002000000000001100000010001111111
100000000000000011010100001011111
1100000111010101110101110000011111
11110111 1110101 1011110000011111
11111111 1111111 11111111111111111