R 1000 800
EA ./textures/t/colorstone.xpm
WE ./textures/t/greystone.xpm
NO ./textures/t/redbrick.xpm
SO ./textures/t/wood.xpm

S ./textures/catto.xpm
F 148,210,246
C 240,158,218

        1111111111111111111111111
        1000000000020000000000001
        1000002000020002200000001
        1000N00000020020002220001
        1000000000000000000000001
        1000000002020200000002001
        1000000000000000000000001
        1000000000000000000000001
111111111011000000000000000000001
100000000011000001110111110111111
11110111111111011100000010001
11110111111111011101010010001111111
11000000110101011100000010000000001
10002000000000001100000010001111111
100000000000000011010100001011111
1100000111010101110101110000011111
11110111 1110101 1011110000011111
11111111 1111111 11111111111111111